{
  "Q1": "",
  "Q2": "",
  "Q3": "",
  "Q4": "",
  "Q5": "",
  "Q6": "",
  "Q7": "",
  "Q8": "",
  "Q9": "",
  "Q10": "",
  "Q11": "",
  "Q12": "",
  "Q13": "",
  "Q14": "",
  "Q15": "",
  "Q16": "",
  "Q17": "",
  "Q18": "",
  "Q19": "",
  "Q20": "",
  "Q21": "",
  "Q22": "",
  "Q23": "",
  "Q24": "",
  "Q25": "",
  "Q26": "",
  "Q27": "",
  "Q28": "",
  "Q29": "",
  "Q30": "",
  "Q31": "",
  "Q32": "",
  "Q33": "",
  "Q34": "",
  "Q35": "",
  "Q36": "",
  "Q37": "",
  "Q38": "",
  "Q39": "",
  "Q40": "",
  "Q41": "",
  "Q42": "",
  "Q43": "",
  "Q44": "",
  "Q45": "",
  "Q46": "",
  "Q47": "",
  "Q48": "",
  "Q49": "",
  "Q50": "",
  "Q51": "",
  "Q52": "",
  "Q53": "",
  "Q54": "",
  "Q55": "",
  "Q56": "",
  "Q57": "",
  "Q58": "",
  "Q59": "",
  "Q60": "",
  "Q61": "",
  "Q62": "",
  "Q63": "",
  "Q64": "",
  "Q65": "",
  "Q66": "",
  "Q67": "",
  "Q68": "",
  "Q69": "",
  "Q70": "",
  "Q71": "",
  "Q72": "",
  "Q73": "",
  "Q74": "",
  "Q75": "",
  "Q76": "",
  "Q77": "",
  "Q78": "",
  "Q79": "",
  "Q80": "",
  "Q81": "",
  "Q82": "",
  "Q83": "",
  "Q84": "",
  "Q85": "",
  "Q86": "",
  "Q87": "",
  "Q88": "",
  "Q89": "",
  "Q90": "",
  "Q91": "",
  "Q92": "",
  "Q93": "",
  "Q94": "",
  "Q95": "",
  "Q96": "",
  "Q97": "",
  "Q98": "",
  "Q99": "",
  "Q100": "",
  "Q101": "",
  "Q102": "",
  "Q103": "",
  "Q104": "",
  "Q105": "",
  "Q106": "",
  "Q107": "",
  "Q108": "",
  "Q109": "",
  "Q110": "",
  "Q111": "",
  "Q112": "",
  "Q113": "",
  "Q114": "",
  "Q115": "",
  "Q116": "",
  "Q117": "",
  "Q118": "",
  "Q119": "",
  "Q120": "",
  "Q121": "",
  "Q122": "",
  "Q123": "",
  "Q124": "",
  "Q125": "",
  "Q126": "",
  "Q127": "",
  "Q128": "",
  "Q129": "",
  "Q130": "",
  "Q131": "",
  "Q132": "",
  "Q133": "",
  "Q134": "",
  "Q135": "",
  "Q136": "",
  "Q137": "",
  "Q138": "",
  "Q139": "",
  "Q140": "",
  "Q141": "",
  "Q142": "",
  "Q143": "",
  "Q144": "",
  "Q145": "",
  "Q146": "",
  "Q147": "",
  "Q148": "",
  "Q149": "",
  "Q150": "",
  "Q151": "",
  "Q152": "",
  "Q153": "",
  "Q154": "",
  "Q155": "",
  "Q156": "",
  "Q157": "",
  "Q158": "",
  "Q159": "",
  "Q160": "",
  "Q161": "",
  "Q162": "",
  "Q163": "",
  "Q164": "",
  "Q165": "",
  "Q166": "",
  "Q167": "",
  "Q168": "",
  "Q169": "",
  "Q170": "",
  "Q171": "",
  "Q172": "",
  "Q173": "",
  "Q174": "",
  "Q175": "",
  "Q176": "",
  "Q177": "",
  "Q178": "",
  "Q179": "",
  "Q180": "",
  "Q181": "",
  "Q182": "",
  "Q183": "",
  "Q184": "",
  "Q185": "",
  "Q186": "",
  "Q187": "",
  "Q188": "",
  "Q189": "",
  "Q190": "",
  "Q191": "",
  "Q192": "",
  "Q193": "",
  "Q194": "",
  "Q195": "",
  "Q196": "",
  "Q197": "",
  "Q198": "",
  "Q199": "",
  "Q200": "",
  "Q201": "",
  "Q202": "",
  "Q203": "",
  "Q204": "",
  "Q205": "",
  "Q206": "",
  "Q207": "",
  "Q208": "",
  "Q209": "",
  "Q210": "",
  "Q211": "",
  "Q212": "",
  "Q213": "",
  "Q214": "",
  "Q215": "",
  "Q216": "",
  "Q217": "",
  "Q218": "",
  "Q219": "",
  "Q220": "",
  "Q221": "",
  "Q222": "",
  "Q223": "",
  "Q224": "",
  "Q225": "",
  "Q226": "",
  "Q227": "",
  "Q228": "",
  "Q229": "",
  "Q230": "",
  "Q231": "",
  "Q232": "",
  "Q233": "",
  "Q234": "",
  "Q235": "",
  "Q236": "",
  "Q237": "",
  "Q238": "",
  "Q239": "",
  "Q240": "",
  "Q241": "",
  "Q242": "",
  "Q243": "",
  "Q244": "",
  "Q245": "",
  "Q246": "",
  "Q247": "",
  "Q248": "",
  "Q249": "",
  "Q250": "",
  "Q251": "",
  "Q252": "",
  "Q253": "",
  "Q254": "",
  "Q255": "",
  "Q256": "",
  "Q257": "",
  "Q258": "",
  "Q259": "",
  "Q260": "",
  "Q261": "",
  "Q262": "",
  "Q263": "",
  "Q264": "",
  "Q265": "",
  "Q266": "",
  "Q267": "",
  "Q268": "",
  "Q269": "",
  "Q270": "",
  "Q271": "",
  "Q272": "",
  "Q273": "",
  "Q274": "",
  "Q275": "",
  "Q276": "",
  "Q277": "",
  "Q278": "",
  "Q279": "",
  "Q280": "",
  "Q281": "",
  "Q282": "",
  "Q283": "",
  "Q284": "",
  "Q285": "",
  "Q286": "",
  "Q287": "",
  "Q288": "",
  "Q289": "",
  "Q290": "",
  "Q291": "",
  "Q292": "",
  "Q293": "",
  "Q294": "",
  "Q295": "",
  "Q296": "",
  "Q297": "",
  "Q298": "",
  "Q299": "",
  "Q300": ""
}